79
6 3 18 3 30 3 42 3 54 3 66 3 78 3 90 3 102 3 
	  18 4 30 4 42 4 54 4 66 4 78 4 90 4			
6 5 18 5 30 5 42 5 54 5 66 5 78 5 90 5 102 5 
	       30 6 42 6 54 6 66 6 78 6 				
6 7 18 7 30 7 42 7 54 7 66 7 78 7 90 7 102 7 
		        42 8 54 8 66 8 						
6 9 18 9 30 9 42 9 54 9 66 9 78 9 90 9 102 9 
				     54 10 	
                     					
6 12 18 12 30 12 42 12 54 12 66 12 78 12 90 12 102 12
6 14 18 14 30 14 42 14 54 14 66 14 78 14 90 14 102 14
6 16 18 16 30 16 42 16 54 16 66 16 78 16 90 16 102 16