72
6 3 18 3 30 3 42 3 54 3 66 3 78 3 90 3 102 3
6 5 18 5 30 5 42 5 54 5 66 5 78 5 90 5 102 5
6 7 18 7 30 7 42 7 54 7 66 7 78 7 90 7 102 7
6 9 18 9 30 9 42 9 54 9 66 9 78 9 90 9 102 9
6 11 18 11 30 11 42 11 54 11 66 11 78 11 90 11 102 11
6 13 18 13 30 13 42 13 54 13 66 13 78 13 90 13 102 13
6 14 18 14 30 14 42 14 54 14 66 14 78 14 90 14 102 14
6 15 18 15 30 15 42 15 54 15 66 15 78 15 90 15 102 15