 45

 6 3                               90 3
 6 5 18 5                     78 5 90 5
 6 7 18 7 30 7           66 7 78 7 90 7
 6 9 18 9 30 9 42 9 54 9 66 9 78 9 90 9
 6 11 18 11 30 11 42 11 54 11 66 11 78 11 90 11
 6 13 18 13 30 13           66 13 78 13 90 13
 6 15 18 15                     78 15 90 15
 6 17                               90 17
 6 17                               90 17
 6 17                               90 17


